fxp: udl vii hgb qmy
ixc: cje lra jhu
sgn: apv vbc
wua: knq
fnr: csd awl vvj fyx cvi xhb mvn guw wid vbp uvk krt oil izj zlh gwv
krt: grp cml vxt
hwj: laq jlg
rus: out
oag: wrc gpp
uos: zqg aiu gdx
xpu: qpb zqg gdx aiu
mdb: fnr mwu ozd
yrt: jlg ifs laq
eao: txi jmk xee sta knq
qcj: ivn mwb nrx lgx
wks: fyy lyd
xso: rqn flj fak
ucp: wpn mpy
zcf: knq sta xee jmk
sdr: vfy gsc wfb
ggn: brb ylm kdl rnk
tky: wcx ytk hbp xjh dne
kzl: sft sof utn
epc: uhn cqf xwv
srh: shh mei
uqe: sft
htw: hmf aia wsm
wid: qwo
daz: yvs
bdl: ipm kkp
xay: mpi
bsb: epc jpb cqs ixc cur ril ybr
mwb: out
cxr: yvs
ruf: jax uvl ctm
vtp: rbo
tqs: kdl pje ylm brb
thb: out
ljy: ael tqw
tkl: ssx yds
ozd: itv csd vvj fyx awl xhb mvn guw vbp hzn yft mfv izj oil uvk cui krt myo fqn gwv zlh
uhn: lzx dac iqf
zad: wvh tmc ece
qlf: gce sgn fni
kcf: dka pvw uzw
uat: bda mkd
aai: gtk gkf cuk qcj
mfv: cml
qlv: wdr sbi ihm nww jkx bud qxb
paz: kbq osk
rys: iwh
gdx: out
hco: cuk gkf
gte: wks fft
zrw: iur mei shh
izj: elj wrh vnz uss
lur: jpb zib zwl uzn epc nta cur cqs ybr tkl sle
hgu: jmk xee
okf: ypu gye qzd
mli: dir mzw
shh: rjp
nhj: ael tqw
pbm: fxp dfl
vnz: che
vim: bmu
puz: dcl ofd
zrg: ihy
scj: ysr knu
pjc: uvl jax bvs
tbn: uat lkd fdg
rcp: okf
min: out
poc: rta yvs rbo
kde: bcz
wct: bvs jax uvl
wvh: brg
wrh: frd kbe ihy
fak: jwl lzu dni
zaq: jlg ifs laq ppm
yun: kde kob qmz uxn
boa: yql brg fbt sgu
izk: czt
xyj: out
xhk: ril cur yun pmu nta epc uzn zwl rxn sle tkl puz ixc cqs nqo jpb zzk
yql: mjy cfo bpj vqp
dcl: nbq
ogv: utn sof pld
rtp: gpp gmb eka
nki: jmk xee knq
agn: jly alh ola zcf
vrp: hnw
lts: yql fbt sgu
myo: rhq kvi
jpb: dcl xuk
dju: vrt ozd fnr you mwu
hnw: hmf
rhq: ehc
dij: knq sta xee txi
awl: vxt
knu: bsb lur igu
dfo: pab
ewm: sgn fni gce
fed: osk
nwy: ppm laq qgn
wby: you mwu fnr ozd
dir: jmn gpu
mjy: wfb iyi vfy
fcj: zkn hgq szd
mzo: out
lzl: xhk
czt: xcu xvu
tyq: gsc wfb kjq iyi
tda: rbo
ltv: srf vim mli slg
iwh: qpo
hnn: bsb fpb lur
fan: sgu
vqp: zow rqn fak flj wke
ltm: pvm xmq
cyc: dfl fxp
kvi: gwp jnw
srd: ipm jrk
lkv: fnr vrt
shb: hxf thb rus
xuk: zxj
ifs: ryr gep wck lcp fwn gdh foj
ynz: uji
igh: sta jmk
fyx: krd
gkf: ivn mwb axi
bcz: ftm rdm wby lkv
qeg: jlg qgn ifs ppm
goq: icv
qmy: out
wxl: igh heh hvs
kbe: dzp ybw
hxf: out
tqw: rdn nac
bmu: jmn gkl xfg
cqf: lzx
phn: rbi fjm
ykt: sgu fbt brg
zqg: out
ain: mpj
esz: jmk txi
bpj: rqn zow flj wke fak
qaj: gtk gkf cuk qcj
kul: ckh
rss: dka nwy
gaq: ifs laq jlg
ehc: hco qaj qup
saf: mwu you fnr vrt
mub: bee
tns: lyd fyy bqw
ssx: utb nel thp hhu wbs
mwd: qeg gpo
lgx: out
lyr: ozd
knq: qlf tnt bhv aeo ljy dmr
php: sgu
qmz: fer bcz
oab: lup
sof: ikt
lte: ytk hbp xjh dne wcx
hvs: xee txi knq
bnw: yhu qhx
jnw: aai hco qup nxs
uge: bqw fyy
cml: sid txz qgh
sle: uwp jhu lra ltm
uoi: yql sgu
tcu: eao hgu
aaj: laq ppm
bqy: you
gye: qpo
csx: you mwu fnr vrt
uut: dne xjh wcx
tat: kul jxm dxd shb wtu
sbi: yvn mub
uss: suv ihy kbe
def: wrc eka gpp
rso: out
dmr: oab kbr jaa
jhu: xmq
qxb: mub sfu fhq yvn
nww: htw
szd: zfx
gpp: qvv min rso iey
sft: fzl hnn ikt
fwn: mei iur
giz: txi sta jmk
you: hzn izj oil krt wid awl vbp csd
yvs: fpb lur xhk bsb
mci: jrk ipm kkp
nqo: uwp jhu cje
alh: jmk xee sta txi
ejz: fjm rbi fim
jnd: wua esz
igu: nta pmu yun cur ril ybr rxn zwl uzn fnn cqs ixc puz sle zzk jpb nqo zib
yft: tky kcj
vxt: sid
dni: hvs heh mpi
jwy: wtu
ypu: yrt
rqn: lzu dni
yfw: bag puu yba
vgx: amv gte qwd hpw
hgb: out
gwp: nxs qaj
obo: fbt
yhu: xkn jai boa
phi: bqy ftm
cmi: xyj
mvn: ruf btp
utn: ikt
mkd: zcf giz alh
eff: zow rqn wke flj
dml: yql brg sgu fbt
ivn: out
fft: fyy lyd
vbp: vnz
cuk: ivn lgx axi nrx
brb: lts bcq xsx fan
ckh: out
cui: zrg elj wrh vnz uss
ybw: pxr
sfu: bee ynz
aov: gyl xyj
yxq: jsh smb qhx
hgq: xvu
yba: pab xbk bvq
ser: mzo vii hgb qmy
xfg: txi xee
iey: out
vhi: jaa kbr evt ndc
kcj: hbp
qmf: zfx
tum: sgu brg yql
sva: her yfw anr
ctm: cyc
sta: ewm izk bhv tnt vhi hkq ljy waa aeo ofz xhd fcj gwo qlf nhj
jai: fbt sgu
iyj: dka kez nwy
ofd: tlb
qff: rcp osk
wbs: fnr you mwu vrt ozd
ulj: hrd tcu uqb
uvk: vxt grp qgy
txz: irm jwy fmr
yco: out
hlo: fxp ser
gsc: ldf yqe ulj
vpo: zxj tlb
jgf: laq
hns: uoi tmc ece
cvi: gpt otp sva
cur: kob kde qmz
lre: ipm
ryr: wpn fdl
wrc: iey yco
ftq: fvb kbp scb oap cvl
qwd: tns wks uge
laq: ryr nhf srh zrw bvv xje gep phn ejz ucp vgx foj gdh tph
fyy: vin obo dml php tum
iyi: yqe ldf axk
wck: mei iur
lzu: mpi
btp: uvl ctm bvs jax
zib: jhu lra cje ltm uwp
dac: lyr csx saf rmg vns
pje: lts ykt bcq
awp: oap kbp
iqf: lyr vns
fac: qgn
iiu: lre
gmb: min rso
pxk: wsm
icv: jlg ifs laq
tnt: oab ndc kbr evt
guw: otp qwo
rjp: fbt sgu
iqh: srf vim mli slg
xje: mpy
cmt: amv gte
kob: bcz fer
fzl: igu fpb
bud: rss fxl
lup: fvb cvl
bpc: jsh smb yhu
jui: fnr mwu you vrt ozd
wmr: tmc uoi wvh
ulo: yql brg sgu
quz: hns avo euq zad
avo: wvh uoi tmc
wtu: rus thb hxf ckh
jsh: xkn ulo boa ahv
bbz: mwd imq
hpw: fft tns uge
nbq: gcg jui zqy
cel: fxp dfl
jrk: lsu nki wgx
qzd: acm yrt qpo
xcu: ain
qxl: lur igu bsb
pmu: xuk dcl ofd
ahv: fbt brg
gtk: lgx nrx
vrt: yft izj uvk cui mfv oil myo hzn gwv zlh fqn guw vbp wid xhb mvn csd itv cvi fyx awl
gcg: vrt
ppm: bvv zrw vis dcr wck ryr gdh tph ucp ejz uuh gep
nel: ozd fnr
udl: out
gkl: knq txi jmk xee
vvj: btp pjc wct
adp: cxr vtp daz poc
zxj: jui gcg zqy
dka: ifs laq qgn jlg
bhl: xpu uos
mzw: jmn xfg
ycr: qmf hgq szd czt
zfx: dbo ain scj
jax: pbm bxg cel cyc hlo
yqe: jnd uqb hrd
lyd: dml php vin obo
euq: uoi ece
hzn: wct
gwv: uut tky lte
wgx: sta xee knq
xhd: phh ael
axk: tcu uqb
ece: sgu fbt
waa: jaa
jaa: ftq lup awp
cje: xmq pvm
lln: bbz qff dkw paz htf fhv vrp jkx ihm bud jef eej
bvs: pbm cel
zow: xay wxl
pvm: fnr you vrt ozd
dbo: knu
vbc: pld
xpp: iwh qzd gye
gep: fdl
qqj: xhk bsb lur fpb
wpo: fdg
qgy: sid qgh
dne: oag def
oap: igu lur bsb xhk
bee: oxm uji tpb jgf
dxd: rus thb
mjp: jgf mkp
ytc: brg yql sgu fbt
zlh: krd kvi rhq
wcx: def oag rtp
svr: qlv lln qwc
ola: sta xee jmk txi
qwc: jkx ihm nww sbi bud fed jef eej bbz qff nfj paz fhv vrp wdr
gce: kzl ogv
uxn: phi bcz
vnd: fbt brg
xee: uni hkq ljy qlf aeo
zaz: cmi
gpt: yfw
dkm: gaq fac aaj zaq
kjq: sgy
oba: qgn jlg
slg: dir
fvb: xhk bsb igu lur
csd: gpt otp qwo
kkp: dij pbf
osk: xpp rys
hmf: pde luh dkm
uwn: lkd
crd: ikt hnn fzl
acm: jlg qgn laq
utb: fnr mwu you
lcp: rbi
mby: out
fbt: tbn iiu uxu sdr wyl uwn xao ltv wpo mjy xso
fhq: ynz mjp
qhx: ahv boa ulo jai
wpn: bpo
xbk: mby
axi: out
rbi: yxq bnw
dcr: fjm
nxs: gkf cuk qcj
rxn: uwp jhu lra ltm
kez: ifs
ikt: xhk bsb igu fpb
nhf: pje
lsu: xee sta jmk
ejp: oba aaj gaq
tph: rnk brb
bpo: wmr euq
ybr: uhn cqf
pde: gaq
kbp: xhk bsb
fhv: pxk htw
lkd: bda mkd agn bhh
fmr: shb wtu kul
ftm: ozd vrt
aeo: szd qmf hgq
dhu: ogv apv vbc kzl
irh: mpj ysr qxl
thp: you ozd vrt
bda: alh jly ola zcf giz
uzw: laq ifs qgn
scb: bsb
aeb: wbs hhu nel utb
vin: brg
rnk: fan
sid: jwy fmr irm
uxu: slg mli vim srf
anr: yba puu zaz
kbq: rys
jwl: igh
vis: amv hpw gte qwd
fer: lkv wby rdm bqy ftm
kwv: ola jly zcf
nac: lur
xvu: phc irh
luh: aaj zaq oba gaq
bcq: fbt sgu brg yql
puu: bvq xbk
mei: rjp ytc vnd
lyf: igu xhk bsb
tmc: fbt
suv: rzo dzp qig bhl
qwo: anr
uuh: iur
dfl: mzo vii
hrd: esz wua
eka: min rso qvv yco
qpb: out
zqy: you mwu
evt: lup
bxg: dfl fxp
uni: oab kbr evt jaa
uwp: xmq dju
rdm: ozd vrt you fnr
gwo: poc
dto: bsb xhk lur fpb
ofz: dhu fni sgn
fjm: bpc
wsm: pde luh ejp
tmb: amv qwd
kdl: bcq ykt lts
jxm: ckh hxf
dyl: euq avo wmr hns
pxr: zqg
xsx: yql brg
wdr: rss fxl kcf
frd: rzo qig dzp bhl
tlb: zqy mdb
yvn: ynz mjp
bvv: fim
xjh: oag def
jmk: vhi bhv tnt izk ewm adp nhj qlf gwo fcj xhd ofz aeo ycr ljy hkq
smb: ahv xkn ulo
hbp: def rtp
fdl: quz bpo
flj: xay wxl
mkp: qgn jlg
fdg: mkd agn bda kwv bhh
mpy: bpo quz dyl
fim: yxq bnw bpc
mwu: xhb yft myo cui gwv mvn fqn fyx vbp wid
yds: hhu nel
her: dfo yba puu bag
ipm: nki wgx lsu pbf
wfb: ulj axk ldf
bvq: xyj
hhu: ozd you fnr
vfy: ulj yqe ldf axk
pld: qqj fzl
zkn: xvu zfx xcu
rbo: fpb lur
zzk: yds aeb
rdn: bsb igu fpb
ril: qmz uxn kde kob
foj: fdl
xhb: krd kvi
htf: osk rcp
nrx: out
zwl: xwv uhn cqf
gyl: out
dkw: rcp osk
sgu: wyl iiu vqp bpj sdr tyq tbn cfo eff wpo xso xao ltv
pbf: sta
ytk: oag
irm: shb kul
brg: wpo iqh tyq tbn uwn
dzp: xpu uos
ufe: utb nel hhu
gpo: jlg
ihy: bhl rzo dzp qig
jlg: srh tqs bvv tmb dcr
qgh: jwy fmr tat irm
aiu: out
itv: grp qgy
cqs: yds ufe ssx
mpj: igu xhk
pvw: ppm laq
mpi: xee knq
pab: gyl
jef: rss kcf iyj
qig: pxr xpu
lra: pvm
che: rzo qig dzp ybw
xao: rqn fak wke
nta: vpo xuk
rta: lur igu bsb
qvv: out
fpb: puz cqs ixc fnn tkl nqo jpb zzk zib yun cur pmu nta ybr ril uzn zwl
imq: hwj qeg gpo
jkx: fhq mub sfu
ael: lzl dto
wyl: srd bdl mci
hkq: zkn czt
apv: utn crd sof pld
kbr: ftq
xwv: iqf lzx
cfo: lre bdl srd
ysr: fpb xhk bsb
aia: dkm ejp
ndc: awp lup ftq
bhh: ola
bhv: poc daz vtp tda cxr
uqb: hgu
xkn: yql
eej: imq
ihm: htw pxk
phh: rdn lyf nac
cvl: fpb igu lur xhk
rzo: uos
uzn: kde
jly: jmk sta xee knq
otp: her
vii: out
fni: ogv uqe kzl
phc: ysr
srf: bmu mzw
fnn: xwv
rmg: you
heh: knq jmk xee txi
elj: frd kbe che suv
fxl: dka kez pvw uzw
sgy: uqb
vns: vrt fnr
gdh: hpw
bag: pab aov xbk cmi
bqw: dml tum php
txi: aeo dmr adp waa nhj uni
krd: gwp
wke: dni wxl jwl
ldf: uqb tcu hrd
jmn: knq xee jmk
ylm: fan bcq lts
qpo: ppm laq qgn jlg
qgn: ucp ejz phn cmt lcp uuh xje tqs gep foj gdh tph nhf fwn dcr wck ryr bvv tmb zrw srh vis ggn
tpb: ifs laq
uvl: hlo cel bxg pbm
iur: rjp vnd ytc
oil: uut lte
oxm: ppm laq qgn jlg
grp: qgh sid
lzx: vns csx saf
uji: qgn jlg ppm laq
amv: wks uge tns
qup: qcj
xmq: mwu you
fqn: sva
gpu: sta xee jmk txi
nfj: mwd goq
